xxxxxxxxxxxxxxxxxxxx
x000000000000000000x
x0xx00000000xxxxx00x
x000000000000000000x
x0000000xxxxx000x00x
x00xx00000000000000x
x000000xxxxxxx0x000x
x0x000000000000x000x
x00x0x0000xxx00x200x
x00000000x000000000x
x000000000000000000x
x0xxxxxxxxx00000xx0x
x0000000000xxxx0000x
x000000000000000000x
x0000000000xxxx0000x
x00xxxxxxxx00000000x
x010000000000000000x
x000000000000000000x
x000000000000000000x
xxxxxxxxxxxxxxxxxxxx